CALIBRATE	K AE L AH B R EY T
CONFIGURATION	K AH N F IH G Y ER EY SH AH N
EIGHT	EY T
EXECUTE	EH K S AH K Y UW T
FIVE	F AY V
FOUR	F AO R
GO	G OW
HERE	HH IY R
HOME	HH OW M
LAST	L AE S T
NINE	N AY N
ONE	W AH N
ONE(2)	HH W AH N
SEND	S EH N D
SEVEN	S EH V AH N
SIX	S IH K S
START	S T AA R T
STOP	S T AA P
TELEOPERATION	T EH L AH AA P ER EY SH AH N
THREE	TH R IY
TRAJECTORY	T R AH JH EH K T ER IY
TWO	T UW
